0   0   0  -5  -5  -5  -5  -5  -5  -5   0   0   0   0   0   0   0 -10   0   0
0   0   0   0   0   0   0   0  -5  -5   0   0   0   0   0   0   0 -10   0   0
0   0   0   0   0   0   0   0  -5  -5   0   0   0   0   0   0   0 -10   0  50 
0   0   0   0   0   0   0   0  -5  -5   0   0   0  -5  -5  -5  -5 -10   0  50
0   0   0  -5  -5   0   0   0  -5  -5   0   0   0   0   0   0   0   0   0 200
0   0   0   0  -5   0   0   0  -5  -5   0   0   0   0   0   0   0   0   0 200
0   0   0   0  -5   0   0   0  -5  -5   0   0   0   0   0   0   0   0   0 200
0   0   0   0  -5   0   0   0  -5  -5   0   0   0  -5  -5   0   0  -5   0  50
0   0   0   0  -5   0   0   0  -5  -5   0   0   0  -5  -5   0   0  -5 -10   0
0   0   0   0  -5   0   0   0   0   0   0   0   0  -5  -5   0   0  -5   0   0
0   0   0   0  -5   0   0   0   0   0   0   0   0  -5  -5   0   0  -5 -10   0
0   0   0   0  -5   0   0   0   0   0   0   0   0  -5  -5   0   0  -5   0   0
0   0   0   0  -5  -5  -5  -5  -5  -5  -5  -5  -5  -5  -5   0   0  -5 -10   0
0   0   0   0   0  -5  -5  -5  -5  -5  -5  -5  -5  -5   0   0   0  -5   0   0
0   0   0   0   0   0   0   0   0   0   0   0   0   0   0   0   0  -5 -10   0
0   0   0   0   0   0   0   0   0   0   0   0   0   0   0   0   0  -5   0  50
0   0   0   0   0   0   0   0   0   0   0   0   0   0   0   0   0  -5 -10   0

